1111111111111111111111111
100000000000000000000E001
1011111111111111111111101
1010000000000000000000101
1010111111111111111100101
1010100000000000000000101
1010101111111111111101101
1010001000000000000000101
1011111011111111111101101
1000001000000000000000101
1101111011111111111111101
1000000000000000000C01001
1011111111111111111111101
10000000000000000000001P1
1111111111111111111111111
