1111110000011111111
10CC011000000000001
1010001E00000000001
1C00P01000000000011
1000000000000000001
100000C000000000001
1000000000000000001
10000000000000C0001
1111111111111111111
