1111111111
10CC011001
1010101E01
1C01P11011
1010101001
1001000C01
11C1010001
1111111111
